02 02 02 02 02 02 02 02 02 02 02 02 02 02 02 02 02 00 03 03 00 00 00 00 00 00 00 00 00 00 00 00 00 00 00 00 00 00 00 00 00 00 00 00 00 00 00 00
02 02 02 02 02 02 02 02 02 02 02 02 02 02 02 02 02 00 03 03 00 00 00 00 00 00 00 00 00 00 00 00 00 00 00 00 00 00 00 00 00 00 00 00 00 00 00 00
04 04 04 04 04 04 04 04 04 04 04 04 04 00 02 02 02 00 03 03 00 00 00 00 00 00 00 00 00 00 00 00 00 00 00 00 00 00 00 00 00 00 00 00 00 00 00 00
03 03 03 03 03 03 03 03 03 03 03 03 03 00 02 02 02 00 03 03 00 00 00 00 00 00 00 00 00 00 00 00 00 00 00 00 00 00 00 00 00 00 00 00 00 00 00 00
03 03 03 03 03 03 03 03 03 03 03 03 03 00 02 02 02 00 03 03 00 00 00 00 00 00 00 00 00 00 00 00 00 03 03 03 03 03 03 03 03 03 03 03 00 00 00 00
08 08 03 03 03 03 03 03 03 15 16 03 03 00 02 02 02 00 03 03 00 00 00 00 00 00 00 00 00 00 00 00 03 03 03 03 03 03 03 03 03 03 03 03 00 00 00 00
02 02 10 03 03 03 03 03 03 03 17 03 03 00 02 02 02 00 03 03 03 00 00 00 00 00 00 00 00 00 00 03 03 03 03 03 03 03 03 00 00 00 00 00 00 00 00 00
02 02 10 03 03 03 03 03 00 00 00 00 00 00 02 02 02 00 03 03 03 03 03 03 03 03 03 03 03 03 03 03 03 03 03 03 03 03 03 00 00 00 00 00 00 00 00 00 
02 02 10 03 03 03 03 03 00 00 00 00 00 00 02 02 02 00 03 03 03 03 03 03 03 03 03 03 03 03 03 03 03 03 00 00 00 00 00 00 00 00 00 00 00 00 00 00 
02 02 10 03 03 03 03 03 00 00 00 00 00 00 02 02 02 00 03 03 03 03 03 03 03 03 03 03 03 03 03 03 03 03 00 00 00 00 00 00 00 00 00 00 00 00 00 00
02 02 00 00 00 00 00 00 00 00 00 00 00 00 02 02 02 00 03 03 03 03 03 03 03 03 03 03 03 03 03 03 03 03 00 00 00 00 00 00 00 00 00 00 00 00 00 00 
02 02 02 02 02 02 02 02 02 02 02 02 02 02 02 02 02 00 03 03 03 03 03 03 03 03 03 03 03 03 03 03 03 03 03 03 03 03 03 03 03 00 00 00 00 00 00 00 
02 02 02 02 02 02 02 02 02 02 02 02 02 02 02 02 02 00 03 03 03 03 03 03 03 03 03 03 03 03 03 03 03 03 03 03 03 03 03 03 03 00 00 00 00 00 00 00 
02 02 02 02 02 02 02 02 02 02 02 02 02 02 02 02 02 00 03 03 03 03 03 03 03 03 03 03 03 03 03 03 03 00 00 00 00 00 00 00 00 00 00 00 00 00 00 00 
02 02 02 00 00 00 00 00 00 00 00 00 00 00 00 00 00 00 03 03 00 00 00 00 00 00 00 00 00 00 00 03 03 00 00 00 00 00 00 00 00 00 00 00 00 00 00 00 
02 02 02 00 00 00 00 00 00 00 00 00 00 00 00 00 00 00 03 03 00 00 00 00 00 00 00 00 00 00 00 03 03 00 00 00 00 00 00 00 00 00 00 00 00 00 00 00 
02 02 02 00 00 00 00 00 00 00 00 00 00 00 00 00 00 00 03 03 00 00 00 00 00 00 00 00 00 00 00 03 03 00 00 00 00 00 00 00 00 00 00 00 00 00 00 00 
02 02 02 00 00 00 00 00 00 00 00 00 00 00 00 00 00 00 03 03 00 00 00 00 00 03 03 00 00 00 00 03 03 00 00 00 00 00 00 00 00 00 00 00 00 00 00 00 
02 02 02 00 00 00 00 00 00 00 00 00 00 00 00 00 00 00 03 03 00 00 00 00 00 03 03 00 00 00 00 03 03 00 00 00 00 00 00 00 00 00 00 00 00 00 00 00 
02 02 02 00 00 00 00 00 00 00 00 00 00 00 00 00 00 00 03 03 00 00 00 00 00 03 03 00 00 00 00 03 03 00 00 00 00 00 00 00 00 00 00 00 00 00 00 00 
02 02 02 00 00 00 00 00 00 00 00 00 00 00 00 00 00 00 00 00 00 00 00 00 00 03 03 00 00 00 00 03 03 00 00 00 00 00 00 00 00 00 00 00 00 00 00 00 
02 02 02 00 00 00 00 00 00 00 00 00 00 00 00 00 00 00 00 00 00 00 00 00 00 03 03 00 00 00 00 03 03 00 00 00 00 00 00 00 00 00 00 00 00 00 00 00 
02 02 02 02 02 02 02 02 02 02 02 02 02 02 02 02 02 02 02 02 02 02 02 02 00 03 03 00 00 00 00 03 03 00 00 00 00 00 00 00 00 00 00 00 00 00 00 00 
02 02 02 02 02 02 02 02 02 02 02 02 02 02 02 02 02 02 02 02 02 02 02 02 00 03 03 00 00 00 00 00 00 00 00 00 00 00 00 00 00 00 00 00 00 00 00 00 
02 02 02 02 02 02 02 02 02 02 02 02 02 02 02 02 02 02 02 02 02 02 02 02 00 03 03 00 00 00 00 00 00 00 00 00 00 00 00 00 00 00 00 00 00 00 00 00 
02 02 02 01 01 01 01 01 01 01 01 01 01 01 01 01 01 01 01 01 01 02 02 02 00 03 03 00 00 00 00 00 00 00 00 00 00 00 00 00 00 00 00 00 00 00 00 00 
02 02 02 01 12 14 14 14 13 14 14 14 14 14 14 14 12 13 14 14 01 02 02 02 00 03 03 00 00 00 00 00 00 00 00 00 00 00 00 00 00 00 00 00 00 00 00 00 
